2,0,0,0,0,0,0,0,0,0,0,0,0,0,0,0,0,0,0,0,0,2
2,0,0,0,0,0,0,0,0,0,0,0,0,0,0,0,0,0,0,0,0,2
2,0,0,0,0,6,0,0,0,0,0,0,0,0,0,0,0,0,0,0,0,2
2,0,0,0,0,0,0,0,0,0,0,0,0,0,0,0,0,0,0,0,6,2
2,0,0,0,2,2,2,0,0,5,2,0,0,2,5,2,0,0,2,2,2,2
2,0,0,0,0,0,0,0,0,0,0,6,0,0,0,0,0,0,0,0,0,2
2,2,5,6,0,0,0,0,0,0,0,0,0,0,0,0,0,0,0,0,0,2
2,0,0,2,2,6,0,6,0,0,0,0,0,0,0,0,0,0,0,0,0,2
2,0,0,0,0,2,0,0,0,0,0,0,0,0,6,0,0,0,0,0,0,2
2,0,0,0,0,0,2,2,2,6,0,0,0,0,0,0,0,0,0,0,1,2
2,0,0,0,0,0,0,0,0,2,2,0,2,0,2,0,2,2,2,2,2,2